

NO              ./path_to_the_north_texture        

SO ./path_to_the_south_texture



F 220,100,0

C 225,30,0

WE ./path_to_the_west_texture 
EA ./path_to_the_east_texture      



1111111
1101011
1010101
110N011
1010101
1100011
1010101
1100011
1010101
1100011
1010101
1100011
1010101
1100011
1010101
1100011
1010101
1100011
1010101
1100011
1010101
1100011
1010101
1100011
1010101
1100011
1010101
1100011
1010101
1100011
1010101
1100011
1010101
1100011
1010101
1100011
1010101
1100011
1010101
1100011
1010101
1100011
1010101
1100011
1010101
1100011
1010101
1100011
1010101
1100011
1010101
1100011
1010101
1100011
1010101
1100011
1010101
1100011
1010101
1100011
1010101
1100011
1010101
1100011
1010101
1100011
1010101
1100011
1010101
1100011
1010101
1100011
1010101
1100011
1010101
1100011
1010101
1100011
1010101
1100011
1010101
1100011
1010101
1100011
1010101
1100011
1010101
1100011
1010101
1100011
1010101
1100011
1010101
1100011
1010101
1100011
1010101
1100011
1010101
1100011
1010101
1100011
1010101
1100011
1010101
1100011
1010101
1100011
1010101
1100011
1010101
1100011
1010101
1100011
1010101
1100011
1010101
1100011
1010101
1100011
1010101
1100011
1010101
1100011
1010101
1100011
1010101
1100011
1010101
1100011
1010101
1100011
1010101
1100011
1010101
1100011
1010101
1100011
1010101
1100011
1010101
1100011
1010101
1100011
1010101
1100011
1010101
1100011
1010101
1100011
1010101
1100011
1010101
1100011
1010101
1100011
1010101
1100011
1010101
1100011
1010101
1100011
1010101
1100011
1010101
1100011
1010101
1100011
1010101
1100011
1010101
1100011
1010101
1100011
1010101
1100011
1010101
1100011
1010101
1100011
1010101
1100011
1010101
1100011
1010101
1100011
1010101
1100011
1010101
1100011
1010101
1100011
1010101
1100011
1010101
1100011
1010101
1100011
1010101
1100011
1010101
1100011
1010101
1100011
1010101
1100011
1010101
1100011
1010101
1100011
1010101
1100011
1010101
1100011
1010101
1100011
1010101
1100011
1010101
1100011
1010101
1100011
1010101
1100011
1010101
1100011
1010101
1100011
1010101
1100011
1010101
1100011
1010101
1100011
1010101
1100011
1010101
1100011
1010101
1100011
1010101
1100011
1010101
1100011
1010101
1111111