

NO               assets/textures/north.xpm  

SO assets/textures/south.xpm



F 220,100,0

C 225,30,0

WE assets/textures/west.xpm 
EA assets/textures/east.xpm      



1111111111111111111111111
1000000000110000001000001
10110000011100S0010000001
1001000000000101000000001
100000000011101001110111111111111
111111111011110001110000000000001
111101111111110111000000100011111
11110111111111011101010010001
11000000110101011100000010001
10000000000000000000000000001
10000000000000001101010010001
1100000111010101111101111000111
11110111 1110101 101111010001
11111111 1111111 111111111111